##########
#1......2#
#........#
#.######.#
#.A....B.#
#.######.#
#........#
#2......1#
##########