##########
#1......2#
#........#
#.######.#
#.AAABBB.#
#.######.#
#........#
#2......1#
##########