####################
#111111......222222#
#......######......#
#......######......#
#......######......#
#................AA#
####################