####################
#111111......222222#
#......######......#
#......######......#
#......######......#
#..................#
#..................#
#..................#
#..................#
#..................#
#..................#
#..................#
#..................#
#......######......#
#AAAAAA......BBBBBB#
####################