##########
#1......A#
#.#.######
#.#......#
#.#.######
#2......B#
##########
