##########
#1.......#
#.######.#
#.#....#.#
#.#.##.#.#
#.#.##2#.#
#.#......#
#.######.#
#B......A#
##########