##########
#2#....#1#
#.#.##.#.#
#.#.##.#.#
#........#
#.######.#
#A#....#B#
##########
